#######################################
# Syntax Coloring Map For NFC-RFAL
#######################################

#######################################
# Datatypes (KEYWORD1)
#######################################

NdefClass	KEYWORD1
RfalNfcClass	KEYWORD1
RfalRfClass	KEYWORD1

#######################################
# Methods and Functions (KEYWORD2)
#######################################

ndefPollerContextInitialization	KEYWORD2
ndefPollerNdefDetect	KEYWORD2
ndefPollerReadBytes	KEYWORD2
ndefPollerWriteBytes	KEYWORD2
ndefPollerReadRawMessage	KEYWORD2
ndefPollerWriteRawMessage	KEYWORD2
ndefPollerTagFormat	KEYWORD2
ndefPollerWriteRawMessageLen	KEYWORD2
ndefPollerWriteMessage	KEYWORD2
ndefPollerCheckPresence	KEYWORD2
ndefPollerCheckAvailableSpace	KEYWORD2
ndefPollerBeginWriteMessage	KEYWORD2
ndefPollerEndWriteMessage	KEYWORD2
ndefT2TPollerContextInitialization	KEYWORD2
ndefT2TPollerNdefDetect	KEYWORD2
ndefT2TPollerReadBytes	KEYWORD2
ndefT2TPollerWriteBytes	KEYWORD2
ndefT2TPollerReadRawMessage	KEYWORD2
ndefT2TPollerWriteRawMessage	KEYWORD2
ndefT2TPollerWriteRawMessageLen	KEYWORD2
ndefT2TPollerTagFormat	KEYWORD2
ndefT2TPollerCheckPresence	KEYWORD2
ndefT2TPollerCheckAvailableSpace	KEYWORD2
ndefT2TPollerBeginWriteMessage	KEYWORD2
ndefT2TPollerEndWriteMessage	KEYWORD2
ndefT3TPollerContextInitialization	KEYWORD2
ndefT3TPollerNdefDetect	KEYWORD2
ndefT3TPollerReadBytes	KEYWORD2
ndefT3TPollerWriteBytes	KEYWORD2
ndefT3TPollerReadRawMessage	KEYWORD2
ndefT3TPollerWriteRawMessage	KEYWORD2
ndefT3TPollerWriteRawMessageLen	KEYWORD2
ndefT3TPollerTagFormat	KEYWORD2
ndefT3TPollerCheckPresence	KEYWORD2
ndefT3TPollerCheckAvailableSpace	KEYWORD2
ndefT3TPollerBeginWriteMessage	KEYWORD2
ndefT3TPollerEndWriteMessage	KEYWORD2
ndefT4TPollerContextInitialization	KEYWORD2
ndefT4TPollerNdefDetect	KEYWORD2
ndefT4TPollerSelectNdefTagApplication	KEYWORD2
ndefT4TPollerSelectFile	KEYWORD2
ndefT4TPollerReadBinary	KEYWORD2
ndefT4TPollerReadBinaryODO	KEYWORD2
ndefT4TPollerReadBytes	KEYWORD2
ndefT4TPollerWriteBinary	KEYWORD2
ndefT4TPollerWriteBinaryODO	KEYWORD2
ndefT4TPollerWriteBytes	KEYWORD2
ndefT4TPollerReadRawMessage	KEYWORD2
ndefT4TPollerWriteRawMessage	KEYWORD2
ndefT4TPollerWriteRawMessageLen	KEYWORD2
ndefT4TPollerTagFormat	KEYWORD2
ndefT4TPollerCheckPresence	KEYWORD2
ndefT4TPollerCheckAvailableSpace	KEYWORD2
ndefT4TPollerBeginWriteMessage	KEYWORD2
ndefT4TPollerEndWriteMessage	KEYWORD2
ndefT5TPollerContextInitialization	KEYWORD2
ndefT5TPollerNdefDetect	KEYWORD2
ndefT5TPollerReadBytes	KEYWORD2
ndefT5TPollerWriteBytes	KEYWORD2
ndefT5TPollerReadRawMessage	KEYWORD2
ndefT5TPollerWriteRawMessage	KEYWORD2
ndefT5TPollerWriteRawMessageLen	KEYWORD2
ndefT5TPollerTagFormat	KEYWORD2
ndefT5TPollerCheckPresence	KEYWORD2
ndefT5TPollerCheckAvailableSpace	KEYWORD2
ndefT5TPollerBeginWriteMessage	KEYWORD2
ndefT5TPollerEndWriteMessage	KEYWORD2
ndefMessageInit	KEYWORD2
ndefMessageGetInfo	KEYWORD2
ndefMessageGetRecordCount	KEYWORD2
ndefMessageAppend	KEYWORD2
ndefMessageDecode	KEYWORD2
ndefMessageEncode	KEYWORD2
ndefRecordReset	KEYWORD2
ndefRecordInit	KEYWORD2
ndefRecordGetHeaderLength	KEYWORD2
ndefRecordGetLength	KEYWORD2
ndefRecordSetType	KEYWORD2
ndefRecordGetType	KEYWORD2
ndefRecordTypeMatch	KEYWORD2
ndefRecordSetId	KEYWORD2
ndefRecordGetId	KEYWORD2
ndefRecordSetPayload	KEYWORD2
ndefRecordGetPayload	KEYWORD2
ndefRecordDecode	KEYWORD2
ndefRecordEncodeHeader	KEYWORD2
ndefRecordEncode	KEYWORD2
ndefRecordGetPayloadLength	KEYWORD2
ndefRecordGetPayloadItem	KEYWORD2
ndefWifi	KEYWORD2
ndefGetWifi	KEYWORD2
ndefRecordToWifi	KEYWORD2
ndefWifiToRecord	KEYWORD2
ndefMedia	KEYWORD2
ndefGetMedia	KEYWORD2
ndefRecordToMedia	KEYWORD2
ndefMediaToRecord	KEYWORD2
ndefVCard	KEYWORD2
ndefGetVCard	KEYWORD2
ndefRecordToVCard	KEYWORD2
ndefVCardToRecord	KEYWORD2
ndefEmptyType	KEYWORD2
ndefRecordToEmptyType	KEYWORD2
ndefEmptyTypeToRecord	KEYWORD2
ndefRtdDeviceInfo	KEYWORD2
ndefGetRtdDeviceInfo	KEYWORD2
ndefRecordToRtdDeviceInfo	KEYWORD2
ndefRtdDeviceInfoToRecord	KEYWORD2
ndefRtdText	KEYWORD2
ndefGetRtdText	KEYWORD2
ndefRecordToRtdText	KEYWORD2
ndefRtdTextToRecord	KEYWORD2
ndefRtdUri	KEYWORD2
ndefGetRtdUri	KEYWORD2
ndefRecordToRtdUri	KEYWORD2
ndefRtdUriToRecord	KEYWORD2
ndefRtdAar	KEYWORD2
ndefGetRtdAar	KEYWORD2
ndefRecordToRtdAar	KEYWORD2
ndefRtdAarToRecord	KEYWORD2
ndefRecordTypeStringToTypeId	KEYWORD2
ndefRecordToType	KEYWORD2
ndefTypeToRecord	KEYWORD2
ndefRecordSetNdefType	KEYWORD2
ndefRecordGetNdefType	KEYWORD2
rfalNfcWorker	KEYWORD2
rfalNfcInitialize	KEYWORD2
rfalNfcDiscover	KEYWORD2
rfalNfcGetState	KEYWORD2
rfalNfcGetDevicesFound	KEYWORD2
rfalNfcGetActiveDevice	KEYWORD2
rfalNfcSelect	KEYWORD2
rfalNfcDataExchangeStart	KEYWORD2
rfalNfcDataExchangeGetStatus	KEYWORD2
rfalNfcDeactivate	KEYWORD2
rfalIsoDepInitialize	KEYWORD2
rfalIsoDepInitializeWithParams	KEYWORD2
rfalIsoDepFSxI2FSx	KEYWORD2
rfalIsoDepFWI2FWT	KEYWORD2
rfalIsoDepIsRats	KEYWORD2
rfalIsoDepIsAttrib	KEYWORD2
rfalIsoDepListenStartActivation	KEYWORD2
rfalIsoDepListenGetActivationStatus	KEYWORD2
rfalIsoDepGetMaxInfLen	KEYWORD2
rfalIsoDepStartTransceive	KEYWORD2
rfalIsoDepGetTransceiveStatus	KEYWORD2
rfalIsoDepStartApduTransceive	KEYWORD2
rfalIsoDepGetApduTransceiveStatus	KEYWORD2
rfalIsoDepRATS	KEYWORD2
rfalIsoDepPPS	KEYWORD2
rfalIsoDepATTRIB	KEYWORD2
rfalIsoDepDeselect	KEYWORD2
rfalIsoDepPollAHandleActivation	KEYWORD2
rfalIsoDepPollBHandleActivation	KEYWORD2
rfalIsoDepPollHandleSParameters	KEYWORD2
rfalNfcaPollerInitialize	KEYWORD2
rfalNfcaPollerCheckPresence	KEYWORD2
rfalNfcaPollerSelect	KEYWORD2
rfalNfcaPollerSleep	KEYWORD2
rfalNfcaPollerTechnologyDetection	KEYWORD2
rfalNfcaPollerSingleCollisionResolution	KEYWORD2
rfalNfcaPollerFullCollisionResolution	KEYWORD2
rfalNfcaListenerIsSleepReq	KEYWORD2
rfalNfcbPollerInitialize	KEYWORD2
rfalNfcbPollerInitializeWithParams	KEYWORD2
rfalNfcbPollerCheckPresence	KEYWORD2
rfalNfcbPollerSleep	KEYWORD2
rfalNfcbPollerSlotMarker	KEYWORD2
rfalNfcbPollerTechnologyDetection	KEYWORD2
rfalNfcbPollerCollisionResolution	KEYWORD2
rfalNfcbPollerSlottedCollisionResolution	KEYWORD2
rfalNfcbTR2ToFDT	KEYWORD2
rfalNfcDepInitialize	KEYWORD2
rfalNfcDepSetDeactivatingCallback	KEYWORD2
rfalNfcDepCalculateRWT	KEYWORD2
rfalNfcDepATR	KEYWORD2
rfalNfcDepPSL	KEYWORD2
rfalNfcDepDSL	KEYWORD2
rfalNfcDepRLS	KEYWORD2
rfalNfcDepInitiatorHandleActivation	KEYWORD2
rfalNfcDepIsAtrReq	KEYWORD2
rfalNfcDepTargetRcvdATR	KEYWORD2
rfalNfcDepListenStartActivation	KEYWORD2
rfalNfcDepListenGetActivationStatus	KEYWORD2
rfalNfcDepStartTransceive	KEYWORD2
rfalNfcDepGetTransceiveStatus	KEYWORD2
rfalNfcfPollerInitialize	KEYWORD2
rfalNfcfPollerCheckPresence	KEYWORD2
rfalNfcfPollerPoll	KEYWORD2
rfalNfcfPollerCollisionResolution	KEYWORD2
rfalNfcfPollerCheck	KEYWORD2
rfalNfcfPollerUpdate	KEYWORD2
rfalNfcfListenerIsT3TReq	KEYWORD2
rfalNfcvPollerInitialize	KEYWORD2
rfalNfcvPollerCheckPresence	KEYWORD2
rfalNfcvPollerInventory	KEYWORD2
rfalNfcvPollerCollisionResolution	KEYWORD2
rfalNfcvPollerSleepCollisionResolution	KEYWORD2
rfalNfcvPollerSleep	KEYWORD2
rfalNfcvPollerSelect	KEYWORD2
rfalNfcvPollerReadSingleBlock	KEYWORD2
rfalNfcvPollerWriteSingleBlock	KEYWORD2
rfalNfcvPollerReadMultipleBlocks	KEYWORD2
rfalNfcvPollerWriteMultipleBlocks	KEYWORD2
rfalNfcvPollerLockBlock	KEYWORD2
rfalNfcvPollerExtendedLockSingleBlock	KEYWORD2
rfalNfcvPollerExtendedReadSingleBlock	KEYWORD2
rfalNfcvPollerExtendedWriteSingleBlock	KEYWORD2
rfalNfcvPollerExtendedReadMultipleBlocks	KEYWORD2
rfalNfcvPollerExtendedWriteMultipleBlocks	KEYWORD2
rfalNfcvPollerGetSystemInformation	KEYWORD2
rfalNfcvPollerExtendedGetSystemInformation	KEYWORD2
rfalNfcvPollerTransceiveReq	KEYWORD2
rfalSt25tbPollerInitialize	KEYWORD2
rfalSt25tbPollerCheckPresence	KEYWORD2
rfalSt25tbPollerCollisionResolution	KEYWORD2
rfalSt25tbPollerInitiate	KEYWORD2
rfalSt25tbPollerPcall	KEYWORD2
rfalSt25tbPollerSlotMarker	KEYWORD2
rfalSt25tbPollerSelect	KEYWORD2
rfalSt25tbPollerGetUID	KEYWORD2
rfalSt25tbPollerReadBlock	KEYWORD2
rfalSt25tbPollerWriteBlock	KEYWORD2
rfalSt25tbPollerCompletion	KEYWORD2
rfalSt25tbPollerResetToInventory	KEYWORD2
rfalST25xVPollerM24LRReadSingleBlock	KEYWORD2
rfalST25xVPollerM24LRFastReadSingleBlock	KEYWORD2
rfalST25xVPollerM24LRWriteSingleBlock	KEYWORD2
rfalST25xVPollerM24LRReadMultipleBlocks	KEYWORD2
rfalST25xVPollerM24LRFastReadMultipleBlocks	KEYWORD2
rfalST25xVPollerFastReadSingleBlock	KEYWORD2
rfalST25xVPollerFastReadMultipleBlocks	KEYWORD2
rfalST25xVPollerFastExtendedReadSingleBlock	KEYWORD2
rfalST25xVPollerFastExtReadMultipleBlocks	KEYWORD2
rfalST25xVPollerReadConfiguration	KEYWORD2
rfalST25xVPollerWriteConfiguration	KEYWORD2
rfalST25xVPollerReadDynamicConfiguration	KEYWORD2
rfalST25xVPollerWriteDynamicConfiguration	KEYWORD2
rfalST25xVPollerFastReadDynamicConfiguration	KEYWORD2
rfalST25xVPollerFastWriteDynamicConfiguration	KEYWORD2
rfalST25xVPollerPresentPassword	KEYWORD2
rfalST25xVPollerGetRandomNumber	KEYWORD2
rfalST25xVPollerReadMessageLength	KEYWORD2
rfalST25xVPollerFastReadMsgLength	KEYWORD2
rfalST25xVPollerReadMessage	KEYWORD2
rfalST25xVPollerFastReadMessage	KEYWORD2
rfalST25xVPollerWriteMessage	KEYWORD2
rfalST25xVPollerFastWriteMessage	KEYWORD2
rfalT1TPollerInitialize	KEYWORD2
rfalT1TPollerRid	KEYWORD2
rfalT1TPollerRall	KEYWORD2
rfalT1TPollerWrite	KEYWORD2
rfalT2TPollerRead	KEYWORD2
rfalT2TPollerWrite	KEYWORD2
rfalT2TPollerSectorSelect	KEYWORD2
rfalT4TPollerComposeCAPDU	KEYWORD2
rfalT4TPollerParseRAPDU	KEYWORD2
rfalT4TPollerComposeSelectAppl	KEYWORD2
rfalT4TPollerComposeSelectFile	KEYWORD2
rfalT4TPollerComposeSelectFileV1Mapping	KEYWORD2
rfalT4TPollerComposeReadData	KEYWORD2
rfalT4TPollerComposeReadDataODO	KEYWORD2
rfalT4TPollerComposeWriteData	KEYWORD2
rfalT4TPollerComposeWriteDataODO	KEYWORD2
getRfalRf	KEYWORD2
rfalInitialize	KEYWORD2
rfalCalibrate	KEYWORD2
rfalAdjustRegulators	KEYWORD2
rfalSetUpperLayerCallback	KEYWORD2
rfalSetPreTxRxCallback	KEYWORD2
rfalSetPostTxRxCallback	KEYWORD2
rfalDeinitialize	KEYWORD2
rfalSetMode	KEYWORD2
rfalGetMode	KEYWORD2
rfalSetBitRate	KEYWORD2
rfalGetBitRate	KEYWORD2
rfalSetErrorHandling	KEYWORD2
rfalGetErrorHandling	KEYWORD2
rfalSetObsvMode	KEYWORD2
rfalGetObsvMode	KEYWORD2
rfalDisableObsvMode	KEYWORD2
rfalSetFDTPoll	KEYWORD2
rfalGetFDTPoll	KEYWORD2
rfalSetFDTListen	KEYWORD2
rfalGetFDTListen	KEYWORD2
rfalGetGT	KEYWORD2
rfalSetGT	KEYWORD2
rfalIsGTExpired	KEYWORD2
rfalFieldOnAndStartGT	KEYWORD2
rfalFieldOff	KEYWORD2
rfalStartTransceive	KEYWORD2
rfalGetTransceiveState	KEYWORD2
rfalGetTransceiveStatus	KEYWORD2
rfalIsTransceiveInTx	KEYWORD2
rfalIsTransceiveInRx	KEYWORD2
rfalGetTransceiveRSSI	KEYWORD2
rfalWorker	KEYWORD2
rfalISO14443ATransceiveShortFrame	KEYWORD2
rfalISO14443ATransceiveAnticollisionFrame	KEYWORD2
rfalFeliCaPoll	KEYWORD2
rfalISO15693TransceiveAnticollisionFrame	KEYWORD2
rfalISO15693TransceiveEOFAnticollision	KEYWORD2
rfalISO15693TransceiveEOF	KEYWORD2
rfalTransceiveBlockingTx	KEYWORD2
rfalTransceiveBlockingRx	KEYWORD2
rfalTransceiveBlockingTxRx	KEYWORD2
rfalIsExtFieldOn	KEYWORD2
rfalListenStart	KEYWORD2
rfalListenSleepStart	KEYWORD2
rfalListenStop	KEYWORD2
rfalListenGetState	KEYWORD2
rfalListenSetState	KEYWORD2
rfalWakeUpModeStart	KEYWORD2
rfalWakeUpModeHasWoke	KEYWORD2
rfalWakeUpModeStop	KEYWORD2

#######################################
# Constants (LITERAL1)
#######################################

NDEF_MAX_RECORD	LITERAL1
NDEF_SYSINFO_FLAG_DFSID_POS	LITERAL1
NDEF_SYSINFO_FLAG_AFI_POS	LITERAL1
NDEF_SYSINFO_FLAG_MEMSIZE_POS	LITERAL1
NDEF_SYSINFO_FLAG_ICREF_POS	LITERAL1
NDEF_SYSINFO_FLAG_MOI_POS	LITERAL1
NDEF_SYSINFO_FLAG_CMDLIST_POS	LITERAL1
NDEF_SYSINFO_FLAG_CSI_POS	LITERAL1
NDEF_SYSINFO_FLAG_LEN_POS	LITERAL1
NDEF_CMDLIST_READSINGLEBLOCK_POS	LITERAL1
NDEF_CMDLIST_WRITESINGLEBLOCK_POS	LITERAL1
NDEF_CMDLIST_LOCKSINGLEBLOCK_POS	LITERAL1
NDEF_CMDLIST_READMULTIPLEBLOCKS_POS	LITERAL1
NDEF_CMDLIST_WRITEMULTIPLEBLOCKS_POS	LITERAL1
NDEF_CMDLIST_SELECT_POS	LITERAL1
NDEF_CMDLIST_RESETTOREADY_POS	LITERAL1
NDEF_CMDLIST_GETMULTIPLEBLOCKSECSTATUS_POS	LITERAL1
NDEF_CMDLIST_WRITEAFI_POS	LITERAL1
NDEF_CMDLIST_LOCKAFI_POS	LITERAL1
NDEF_CMDLIST_WRITEDSFID_POS	LITERAL1
NDEF_CMDLIST_LOCKDSFID_POS	LITERAL1
NDEF_CMDLIST_GETSYSTEMINFORMATION_POS	LITERAL1
NDEF_CMDLIST_CUSTOMCMDS_POS	LITERAL1
NDEF_CMDLIST_FASTREADMULTIPLEBLOCKS_POS	LITERAL1
NDEF_CMDLIST_EXTREADSINGLEBLOCK_POS	LITERAL1
NDEF_CMDLIST_EXTWRITESINGLEBLOCK_POS	LITERAL1
NDEF_CMDLIST_EXTLOCKSINGLEBLOCK_POS	LITERAL1
NDEF_CMDLIST_EXTREADMULTIPLEBLOCKS_POS	LITERAL1
NDEF_CMDLIST_EXTWRITEMULTIPLEBLOCKS_POS	LITERAL1
NDEF_CMDLIST_EXTGETMULTIPLEBLOCKSECSTATUS_POS	LITERAL1
NDEF_CMDLIST_FASTEXTENDEDREADMULTIPLEBLOCKS_POS	LITERAL1
RFAL_NFC_RF_BUF_LEN	LITERAL1
RFAL_NFC_TECH_NONE	LITERAL1
RFAL_NFC_POLL_TECH_A	LITERAL1
RFAL_NFC_POLL_TECH_B	LITERAL1
RFAL_NFC_POLL_TECH_F	LITERAL1
RFAL_NFC_POLL_TECH_V	LITERAL1
RFAL_NFC_POLL_TECH_AP2P	LITERAL1
RFAL_NFC_POLL_TECH_ST25TB	LITERAL1
RFAL_NFC_LISTEN_TECH_A	LITERAL1
RFAL_NFC_LISTEN_TECH_B	LITERAL1
RFAL_NFC_LISTEN_TECH_F	LITERAL1
RFAL_NFC_LISTEN_TECH_AP2P	LITERAL1
RFAL_NFC_MAX_DEVICES	LITERAL1
RFAL_VERSION	LITERAL1
RFAL_FWT_NONE	LITERAL1
RFAL_GT_NONE	LITERAL1
RFAL_TIMING_NONE	LITERAL1
RFAL_1FC_IN_4096FC	LITERAL1
RFAL_1FC_IN_512FC	LITERAL1
RFAL_1FC_IN_64FC	LITERAL1
RFAL_1FC_IN_8FC	LITERAL1
RFAL_US_IN_MS	LITERAL1
RFAL_1MS_IN_1FC	LITERAL1
RFAL_BITS_IN_BYTE	LITERAL1
RFAL_CRC_LEN	LITERAL1
RFAL_TXRX_FLAGS_DEFAULT	LITERAL1
RFAL_LM_MASK_NFCA	LITERAL1
RFAL_LM_MASK_NFCB	LITERAL1
RFAL_LM_MASK_NFCF	LITERAL1
RFAL_LM_MASK_ACTIVE_P2P	LITERAL1
RFAL_LM_SENS_RES_LEN	LITERAL1
RFAL_LM_SENSB_RES_LEN	LITERAL1
RFAL_LM_SENSF_RES_LEN	LITERAL1
RFAL_LM_SENSF_SC_LEN	LITERAL1
RFAL_NFCID3_LEN	LITERAL1
RFAL_NFCID2_LEN	LITERAL1
RFAL_NFCID1_TRIPLE_LEN	LITERAL1
RFAL_NFCID1_DOUBLE_LEN	LITERAL1
RFAL_NFCID1_SIMPLE_LEN	LITERAL1
RFAL_FDT_LISTEN_NFCA_POLLER	LITERAL1
RFAL_FDT_LISTEN_NFCB_POLLER	LITERAL1
RFAL_FDT_LISTEN_NFCF_POLLER	LITERAL1
RFAL_FDT_LISTEN_NFCV_POLLER	LITERAL1
RFAL_FDT_LISTEN_PICOPASS_POLLER	LITERAL1
RFAL_FDT_LISTEN_AP2P_POLLER	LITERAL1
RFAL_FDT_LISTEN_NFCA_LISTENER	LITERAL1
RFAL_FDT_LISTEN_NFCB_LISTENER	LITERAL1
RFAL_FDT_LISTEN_NFCF_LISTENER	LITERAL1
RFAL_FDT_LISTEN_AP2P_LISTENER	LITERAL1
RFAL_FDT_POLL_NFCA_POLLER	LITERAL1
RFAL_FDT_POLL_NFCA_T1T_POLLER	LITERAL1
RFAL_FDT_POLL_NFCB_POLLER	LITERAL1
RFAL_FDT_POLL_NFCF_POLLER	LITERAL1
RFAL_FDT_POLL_NFCV_POLLER	LITERAL1
RFAL_FDT_POLL_PICOPASS_POLLER	LITERAL1
RFAL_FDT_POLL_AP2P_POLLER	LITERAL1
RFAL_FELICA_LEN_LEN	LITERAL1
RFAL_FELICA_POLL_REQ_LEN	LITERAL1
RFAL_FELICA_POLL_RES_LEN	LITERAL1
RFAL_FELICA_POLL_MAX_SLOTS	LITERAL1
RFAL_WUM_REFERENCE_AUTO	LITERAL1
NDEF_CC_BUF_LEN	LITERAL1
NDEF_NFCV_SUPPORTED_CMD_LEN	LITERAL1
NDEF_SHORT_VFIELD_MAX_LEN	LITERAL1
NDEF_TERMINATOR_TLV_LEN	LITERAL1
NDEF_TERMINATOR_TLV_T	LITERAL1
NDEF_T2T_READ_RESP_SIZE	LITERAL1
NDEF_T3T_BLOCK_SIZE	LITERAL1
NDEF_T3T_MAX_NB_BLOCKS	LITERAL1
NDEF_T3T_MAX_RX_SIZE	LITERAL1
NDEF_T3T_MAX_TX_SIZE	LITERAL1
NDEF_T5T_TxRx_BUFF_HEADER_SIZE	LITERAL1
NDEF_T5T_TxRx_BUFF_FOOTER_SIZE	LITERAL1
NDEF_T5T_TxRx_BUFF_SIZE	LITERAL1
NDEF_RECORD_HEADER_LEN	LITERAL1
NDEF_SHORT_RECORD_LENGTH_MAX	LITERAL1
NDEF_TNF_EMPTY	LITERAL1
NDEF_TNF_RTD_WELL_KNOWN_TYPE	LITERAL1
NDEF_TNF_MEDIA_TYPE	LITERAL1
NDEF_TNF_URI	LITERAL1
NDEF_TNF_RTD_EXTERNAL_TYPE	LITERAL1
NDEF_TNF_UNKNOWN	LITERAL1
NDEF_TNF_UNCHANGED	LITERAL1
NDEF_TNF_RESERVED	LITERAL1
NDEF_TNF_MASK	LITERAL1
NDEF_WIFI_AUTHENTICATION_NONE	LITERAL1
NDEF_WIFI_AUTHENTICATION_WPAPSK	LITERAL1
NDEF_WIFI_AUTHENTICATION_SHARED	LITERAL1
NDEF_WIFI_AUTHENTICATION_WPA	LITERAL1
NDEF_WIFI_AUTHENTICATION_WPA2	LITERAL1
NDEF_WIFI_AUTHENTICATION_WPA2PSK	LITERAL1
NDEF_WIFI_ENCRYPTION_NONE	LITERAL1
NDEF_WIFI_ENCRYPTION_WEP	LITERAL1
NDEF_WIFI_ENCRYPTION_TKIP	LITERAL1
NDEF_WIFI_ENCRYPTION_AES	LITERAL1
NDEF_UUID_LENGTH	LITERAL1
TEXT_ENCODING_UTF8	LITERAL1
TEXT_ENCODING_UTF16	LITERAL1
NDEF_RTD_TEXT_ENCODING_MASK	LITERAL1
NDEF_RTD_TEXT_ENCODING_SHIFT	LITERAL1
NDEF_URI_PREFIX_NONE	LITERAL1
NDEF_URI_PREFIX_HTTP_WWW	LITERAL1
NDEF_URI_PREFIX_HTTPS_WWW	LITERAL1
NDEF_URI_PREFIX_HTTP	LITERAL1
NDEF_URI_PREFIX_HTTPS	LITERAL1
NDEF_URI_PREFIX_TEL	LITERAL1
NDEF_URI_PREFIX_MAILTO	LITERAL1
NDEF_URI_PREFIX_FTP_ANONYMOUS	LITERAL1
NDEF_URI_PREFIX_FTP_FTP	LITERAL1
NDEF_URI_PREFIX_FTPS	LITERAL1
NDEF_URI_PREFIX_SFTP	LITERAL1
NDEF_URI_PREFIX_SMB	LITERAL1
NDEF_URI_PREFIX_NFS	LITERAL1
NDEF_URI_PREFIX_FTP	LITERAL1
NDEF_URI_PREFIX_DAV	LITERAL1
NDEF_URI_PREFIX_NEWS	LITERAL1
NDEF_URI_PREFIX_TELNET	LITERAL1
NDEF_URI_PREFIX_IMAP	LITERAL1
NDEF_URI_PREFIX_RTSP	LITERAL1
NDEF_URI_PREFIX_URN	LITERAL1
NDEF_URI_PREFIX_POP	LITERAL1
NDEF_URI_PREFIX_SIP	LITERAL1
NDEF_URI_PREFIX_SIPS	LITERAL1
NDEF_URI_PREFIX_TFTP	LITERAL1
NDEF_URI_PREFIX_BTSPP	LITERAL1
NDEF_URI_PREFIX_BTL2CAP	LITERAL1
NDEF_URI_PREFIX_BTGOEP	LITERAL1
NDEF_URI_PREFIX_TCPOBEX	LITERAL1
NDEF_URI_PREFIX_IRDAOBEX	LITERAL1
NDEF_URI_PREFIX_FILE	LITERAL1
NDEF_URI_PREFIX_URN_EPC_ID	LITERAL1
NDEF_URI_PREFIX_URN_EPC_TAG	LITERAL1
NDEF_URI_PREFIX_URN_EPC_PAT	LITERAL1
NDEF_URI_PREFIX_URN_EPC_RAW	LITERAL1
NDEF_URI_PREFIX_URN_EPC	LITERAL1
NDEF_URI_PREFIX_URN_NFC	LITERAL1
NDEF_URI_PREFIX_AUTODETECT	LITERAL1
NDEF_URI_PREFIX_COUNT	LITERAL1
NDEF_VCARD_ENTRY_MAX	LITERAL1
NDEF_DEVICE_INFO_MANUFACTURER_NAME	LITERAL1
NDEF_DEVICE_INFO_MODEL_NAME	LITERAL1
NDEF_DEVICE_INFO_DEVICE_UNIQUE_NAME	LITERAL1
NDEF_DEVICE_INFO_UUID	LITERAL1
NDEF_DEVICE_INFO_FIRMWARE_VERSION	LITERAL1
NDEF_DEVICE_INFO_TYPE_COUNT	LITERAL1
BITMASK_1	LITERAL1
BITMASK_2	LITERAL1
BITMASK_3	LITERAL1
BITMASK_4	LITERAL1
RFAL_ISODEP_PROLOGUE_SIZE	LITERAL1
RFAL_ISODEP_PCB_LEN	LITERAL1
RFAL_ISODEP_DID_LEN	LITERAL1
RFAL_ISODEP_NAD_LEN	LITERAL1
ISODEP_SWTX_PARAM_LEN	LITERAL1
ISODEP_CONTROLMSG_BUF_LEN	LITERAL1
RFAL_ISODEP_NO_DID	LITERAL1
RFAL_ISODEP_NO_NAD	LITERAL1
RFAL_ISODEP_FWI_MASK	LITERAL1
RFAL_ISODEP_FWI_SHIFT	LITERAL1
RFAL_ISODEP_FWI_DEFAULT	LITERAL1
RFAL_ISODEP_ADV_FEATURE	LITERAL1
RFAL_ISODEP_DID_MAX	LITERAL1
RFAL_ISODEP_BRI_MASK	LITERAL1
RFAL_ISODEP_BSI_MASK	LITERAL1
RFAL_ISODEP_SAME_BITRATE_MASK	LITERAL1
RFAL_ISODEP_BITRATE_RFU_MASK	LITERAL1
RFAL_ISODEP_MAX_FWT	LITERAL1
RFAL_ISODEP_FSDI_DEFAULT	LITERAL1
RFAL_ISODEP_FSX_KEEP	LITERAL1
RFAL_ISODEP_DEFAULT_FSCI	LITERAL1
RFAL_ISODEP_DEFAULT_FSC	LITERAL1
RFAL_ISODEP_DEFAULT_SFGI	LITERAL1
RFAL_ISODEP_DEFAULT_FWI	LITERAL1
RFAL_ISODEP_APDU_MAX_LEN	LITERAL1
RFAL_ISODEP_ATTRIB_RES_MBLI_NO_INFO	LITERAL1
RFAL_ISODEP_ATTRIB_REQ_PARAM1_DEFAULT	LITERAL1
RFAL_ISODEP_ATTRIB_HLINFO_LEN	LITERAL1
RFAL_ISODEP_ATS_HB_MAX_LEN	LITERAL1
RFAL_ISODEP_ATTRIB_REQ_MIN_LEN	LITERAL1
RFAL_ISODEP_ATTRIB_RES_MIN_LEN	LITERAL1
RFAL_ISODEP_SPARAM_VALUES_MAX_LEN	LITERAL1
RFAL_ISODEP_SPARAM_TAG_BLOCKINFO	LITERAL1
RFAL_ISODEP_SPARAM_TAG_BRREQ	LITERAL1
RFAL_ISODEP_SPARAM_TAG_BRIND	LITERAL1
RFAL_ISODEP_SPARAM_TAG_BRACT	LITERAL1
RFAL_ISODEP_SPARAM_TAG_BRACK	LITERAL1
RFAL_ISODEP_SPARAM_TAG_SUP_PCD2PICC	LITERAL1
RFAL_ISODEP_SPARAM_TAG_SUP_PICC2PCD	LITERAL1
RFAL_ISODEP_SPARAM_TAG_SUP_FRAME	LITERAL1
RFAL_ISODEP_SPARAM_TAG_SEL_PCD2PICC	LITERAL1
RFAL_ISODEP_SPARAM_TAG_SEL_PICC2PCD	LITERAL1
RFAL_ISODEP_SPARAM_TAG_SEL_FRAME	LITERAL1
RFAL_ISODEP_SPARAM_TAG_LEN	LITERAL1
RFAL_ISODEP_SPARAM_TAG_BRREQ_LEN	LITERAL1
RFAL_ISODEP_SPARAM_TAG_PICC2PCD_LEN	LITERAL1
RFAL_ISODEP_SPARAM_TAG_PCD2PICC_LEN	LITERAL1
RFAL_ISODEP_SPARAM_TAG_BRACK_LEN	LITERAL1
RFAL_ISODEP_ATS_TA_DPL_212	LITERAL1
RFAL_ISODEP_ATS_TA_DPL_424	LITERAL1
RFAL_ISODEP_ATS_TA_DPL_848	LITERAL1
RFAL_ISODEP_ATS_TA_DLP_212	LITERAL1
RFAL_ISODEP_ATS_TA_DLP_424	LITERAL1
RFAL_ISODEP_ATS_TA_DLP_848	LITERAL1
RFAL_ISODEP_ATS_TA_SAME_D	LITERAL1
RFAL_ISODEP_ATS_TB_FWI_MASK	LITERAL1
RFAL_ISODEP_ATS_TB_SFGI_MASK	LITERAL1
RFAL_ISODEP_ATS_T0_TA_PRESENCE_MASK	LITERAL1
RFAL_ISODEP_ATS_T0_TB_PRESENCE_MASK	LITERAL1
RFAL_ISODEP_ATS_T0_TC_PRESENCE_MASK	LITERAL1
RFAL_ISODEP_ATS_T0_FSCI_MASK	LITERAL1
RFAL_ISODEP_ATS_T0_OFFSET	LITERAL1
RFAL_ISODEP_MAX_I_RETRYS	LITERAL1
RFAL_ISODEP_MAX_R_RETRYS	LITERAL1
RFAL_ISODEP_MAX_S_RETRYS	LITERAL1
RFAL_ISODEP_RATS_RETRIES	LITERAL1
RFAL_FEATURE_ISO_DEP_IBLOCK_MAX_LEN	LITERAL1
RFAL_FEATURE_ISO_DEP_APDU_MAX_LEN	LITERAL1
RFAL_NFCA_CASCADE_1_UID_LEN	LITERAL1
RFAL_NFCA_CASCADE_2_UID_LEN	LITERAL1
RFAL_NFCA_CASCADE_3_UID_LEN	LITERAL1
RFAL_NFCA_SENS_RES_PLATFORM_MASK	LITERAL1
RFAL_NFCA_SENS_RES_PLATFORM_T1T	LITERAL1
RFAL_NFCA_SEL_RES_CONF_MASK	LITERAL1
RFAL_NFCA_SEL_RES_CONF_T2T	LITERAL1
RFAL_NFCA_SEL_RES_CONF_T4T	LITERAL1
RFAL_NFCA_SEL_RES_CONF_NFCDEP	LITERAL1
RFAL_NFCA_SEL_RES_CONF_T4T_NFCDEP	LITERAL1
RFAL_NFCA_FDTMIN	LITERAL1
RFAL_NFCB_FWTSENSB	LITERAL1
RFAL_NFCB_DFWT	LITERAL1
RFAL_NFCB_AFI	LITERAL1
RFAL_NFCB_PARAM	LITERAL1
RFAL_NFCB_CRC_LEN	LITERAL1
RFAL_NFCB_NFCID0_LEN	LITERAL1
RFAL_NFCB_CMD_LEN	LITERAL1
RFAL_NFCB_SENSB_RES_LEN	LITERAL1
RFAL_NFCB_SENSB_RES_EXT_LEN	LITERAL1
RFAL_NFCB_SENSB_REQ_ADV_FEATURE	LITERAL1
RFAL_NFCB_SENSB_RES_FSCI_MASK	LITERAL1
RFAL_NFCB_SENSB_RES_FSCI_SHIFT	LITERAL1
RFAL_NFCB_SENSB_RES_PROTO_RFU_MASK	LITERAL1
RFAL_NFCB_SENSB_RES_PROTO_TR2_MASK	LITERAL1
RFAL_NFCB_SENSB_RES_PROTO_TR2_SHIFT	LITERAL1
RFAL_NFCB_SENSB_RES_PROTO_ISO_MASK	LITERAL1
RFAL_NFCB_SENSB_RES_FWI_MASK	LITERAL1
RFAL_NFCB_SENSB_RES_FWI_SHIFT	LITERAL1
RFAL_NFCB_SENSB_RES_ADC_MASK	LITERAL1
RFAL_NFCB_SENSB_RES_ADC_ADV_FEATURE_MASK	LITERAL1
RFAL_NFCB_SENSB_RES_ADC_PROPRIETARY_MASK	LITERAL1
RFAL_NFCB_SENSB_RES_FO_DID_MASK	LITERAL1
RFAL_NFCB_SENSB_RES_FO_NAD_MASK	LITERAL1
RFAL_NFCB_SENSB_RES_FO_MASK	LITERAL1
RFAL_NFCB_SENSB_RES_SFGI_MASK	LITERAL1
RFAL_NFCB_SENSB_RES_SFGI_SHIFT	LITERAL1
RFAL_NFCDEP_FRAME_SIZE_MAX_LEN	LITERAL1
RFAL_NFCDEP_DEPREQ_HEADER_LEN	LITERAL1
RFAL_NFCDEP_DEP_HEADER	LITERAL1
RFAL_NFCDEP_HEADER	LITERAL1
RFAL_NFCDEP_SB_LEN	LITERAL1
RFAL_NFCDEP_LEN_LEN	LITERAL1
RFAL_NFCDEP_CMDTYPE_LEN	LITERAL1
RFAL_NFCDEP_CMD_LEN	LITERAL1
RFAL_NFCDEP_DID_LEN	LITERAL1
RFAL_NFCDEP_DEP_PFB_LEN	LITERAL1
RFAL_NFCDEP_DSL_RLS_LEN_NO_DID	LITERAL1
RFAL_NFCDEP_DSL_RLS_LEN_DID	LITERAL1
RFAL_NFCDEP_FS_VAL_MIN	LITERAL1
RFAL_NFCDEP_LR_VAL_MASK	LITERAL1
RFAL_NFCDEP_PP_LR_MASK	LITERAL1
RFAL_NFCDEP_PP_LR_SHIFT	LITERAL1
RFAL_NFCDEP_DID_MAX	LITERAL1
RFAL_NFCDEP_DID_KEEP	LITERAL1
RFAL_NFCDEP_DID_NO	LITERAL1
RFAL_NFCDEP_NAD_NO	LITERAL1
RFAL_NFCDEP_OPER_RTOX_REQ_DIS	LITERAL1
RFAL_NFCDEP_OPER_RTOX_REQ_EN	LITERAL1
RFAL_NFCDEP_OPER_ATN_DIS	LITERAL1
RFAL_NFCDEP_OPER_ATN_EN	LITERAL1
RFAL_NFCDEP_OPER_EMPTY_DEP_DIS	LITERAL1
RFAL_NFCDEP_OPER_EMPTY_DEP_EN	LITERAL1
RFAL_NFCDEP_OPER_FULL_MI_DIS	LITERAL1
RFAL_NFCDEP_OPER_FULL_MI_EN	LITERAL1
RFAL_NFCDEP_BRS_MAINTAIN	LITERAL1
RFAL_NFCDEP_BRS_Dx_MASK	LITERAL1
RFAL_NFCDEP_BRS_DSI_POS	LITERAL1
RFAL_NFCDEP_WT_DELTA	LITERAL1
RFAL_NFCDEP_WT_DELTA_ADJUST	LITERAL1
RFAL_NFCDEP_ATR_REQ_NFCID3_POS	LITERAL1
RFAL_NFCDEP_NFCID3_LEN	LITERAL1
RFAL_NFCDEP_LEN_MIN	LITERAL1
RFAL_NFCDEP_LEN_MAX	LITERAL1
RFAL_NFCDEP_ATRRES_HEADER_LEN	LITERAL1
RFAL_NFCDEP_ATRRES_MIN_LEN	LITERAL1
RFAL_NFCDEP_ATRRES_MAX_LEN	LITERAL1
RFAL_NFCDEP_ATRREQ_MIN_LEN	LITERAL1
RFAL_NFCDEP_ATRREQ_MAX_LEN	LITERAL1
RFAL_NFCDEP_GB_MAX_LEN	LITERAL1
RFAL_NFCDEP_WT_INI_DEFAULT	LITERAL1
RFAL_NFCDEP_WT_INI_MIN	LITERAL1
RFAL_NFCDEP_WT_INI_MAX	LITERAL1
RFAL_NFCDEP_WT_TRG_MAX_D10	LITERAL1
RFAL_NFCDEP_WT_TRG_MAX_D11	LITERAL1
RFAL_NFCDEP_WT_TRG_MAX	LITERAL1
RFAL_NFCDEP_MAX_FWT	LITERAL1
RFAL_NFCDEP_WT_MASK	LITERAL1
RFAL_NFCDEP_BR_MASK_106	LITERAL1
RFAL_NFCDEP_BR_MASK_212	LITERAL1
RFAL_NFCDEP_BR_MASK_424	LITERAL1
RFAL_NFCF_NFCID2_LEN	LITERAL1
RFAL_NFCF_SENSF_RES_LEN_MIN	LITERAL1
RFAL_NFCF_SENSF_RES_LEN_MAX	LITERAL1
RFAL_NFCF_SENSF_RES_PAD0_LEN	LITERAL1
RFAL_NFCF_SENSF_RES_PAD1_LEN	LITERAL1
RFAL_NFCF_SENSF_RES_RD_LEN	LITERAL1
RFAL_NFCF_SENSF_RES_BYTE1	LITERAL1
RFAL_NFCF_SENSF_SC_LEN	LITERAL1
RFAL_NFCF_SENSF_PARAMS_SC1_POS	LITERAL1
RFAL_NFCF_SENSF_PARAMS_SC2_POS	LITERAL1
RFAL_NFCF_SENSF_PARAMS_RC_POS	LITERAL1
RFAL_NFCF_SENSF_PARAMS_TSN_POS	LITERAL1
RFAL_NFCF_POLL_MAXCARDS	LITERAL1
RFAL_NFCF_CMD_POS	LITERAL1
RFAL_NFCF_CMD_LEN	LITERAL1
RFAL_NFCF_LENGTH_LEN	LITERAL1
RFAL_NFCF_HEADER_LEN	LITERAL1
RFAL_NFCF_SENSF_NFCID2_BYTE1_POS	LITERAL1
RFAL_NFCF_SENSF_NFCID2_BYTE2_POS	LITERAL1
RFAL_NFCF_SENSF_NFCID2_PROT_TYPE_LEN	LITERAL1
RFAL_NFCF_SENSF_NFCID2_BYTE1_NFCDEP	LITERAL1
RFAL_NFCF_SENSF_NFCID2_BYTE2_NFCDEP	LITERAL1
RFAL_NFCF_SYSTEMCODE	LITERAL1
RFAL_NFCF_BLOCK_LEN	LITERAL1
RFAL_NFCF_CHECKUPDATE_RES_ST1_POS	LITERAL1
RFAL_NFCF_CHECKUPDATE_RES_ST2_POS	LITERAL1
RFAL_NFCF_CHECKUPDATE_RES_NOB_POS	LITERAL1
RFAL_NFCF_STATUS_FLAG_SUCCESS	LITERAL1
RFAL_NFCF_STATUS_FLAG_ERROR	LITERAL1
RFAL_NFCF_BLOCKLISTELEM_LEN	LITERAL1
RFAL_NFCF_SERVICECODE_RDONLY	LITERAL1
RFAL_NFCF_SERVICECODE_RDWR	LITERAL1
RFAL_NFCV_UID_LEN	LITERAL1
RFAL_NFCV_MAX_BLOCK_LEN	LITERAL1
RFAL_NFCV_BNO_LEN	LITERAL1
RFAL_NFCV_CRC_LEN	LITERAL1
RFAL_NFCV_MAX_GEN_DATA_LEN	LITERAL1
RFAL_NFCV_BLOCKNUM_LEN	LITERAL1
RFAL_NFCV_BLOCKNUM_EXTENDED_LEN	LITERAL1
RFAL_NFCV_PARAM_SKIP	LITERAL1
RFAL_ST25TB_CHIP_ID_LEN	LITERAL1
RFAL_ST25TB_CRC_LEN	LITERAL1
RFAL_ST25TB_UID_LEN	LITERAL1
RFAL_ST25TB_BLOCK_LEN	LITERAL1
RFAL_NFCV_BLOCKNUM_M24LR_LEN	LITERAL1
RFAL_NFCV_ST_IC_MFG_CODE	LITERAL1
RFAL_T1T_UID_LEN	LITERAL1
RFAL_T1T_HR_LENGTH	LITERAL1
RFAL_T1T_HR0_NDEF_MASK	LITERAL1
RFAL_T1T_HR0_NDEF_SUPPORT	LITERAL1
RFAL_T2T_BLOCK_LEN	LITERAL1
RFAL_T2T_READ_DATA_LEN	LITERAL1
RFAL_T2T_WRITE_DATA_LEN	LITERAL1
RFAL_T4T_MAX_CAPDU_PROLOGUE_LEN	LITERAL1
RFAL_T4T_LE_LEN	LITERAL1
RFAL_T4T_LC_LEN	LITERAL1
RFAL_T4T_MAX_RAPDU_SW1SW2_LEN	LITERAL1
RFAL_T4T_CLA	LITERAL1
RFAL_T4T_ISO7816_P1_SELECT_BY_DF_NAME	LITERAL1
RFAL_T4T_ISO7816_P1_SELECT_BY_FILEID	LITERAL1
RFAL_T4T_ISO7816_P2_SELECT_FIRST_OR_ONLY_OCCURENCE	LITERAL1
RFAL_T4T_ISO7816_P2_SELECT_RETURN_FCI_TEMPLATE	LITERAL1
RFAL_T4T_ISO7816_P2_SELECT_NO_RESPONSE_DATA	LITERAL1
RFAL_T4T_ISO7816_STATUS_COMPLETE	LITERAL1
ERR_NONE	LITERAL1
ERR_NOMEM	LITERAL1
ERR_BUSY	LITERAL1
ERR_IO	LITERAL1
ERR_TIMEOUT	LITERAL1
ERR_REQUEST	LITERAL1
ERR_NOMSG	LITERAL1
ERR_PARAM	LITERAL1
ERR_SYSTEM	LITERAL1
ERR_FRAMING	LITERAL1
ERR_OVERRUN	LITERAL1
ERR_PROTO	LITERAL1
ERR_INTERNAL	LITERAL1
ERR_AGAIN	LITERAL1
ERR_MEM_CORRUPT	LITERAL1
ERR_NOT_IMPLEMENTED	LITERAL1
ERR_PC_CORRUPT	LITERAL1
ERR_SEND	LITERAL1
ERR_IGNORE	LITERAL1
ERR_SEMANTIC	LITERAL1
ERR_SYNTAX	LITERAL1
ERR_CRC	LITERAL1
ERR_NOTFOUND	LITERAL1
ERR_NOTUNIQUE	LITERAL1
ERR_NOTSUPP	LITERAL1
ERR_WRITE	LITERAL1
ERR_FIFO	LITERAL1
ERR_PAR	LITERAL1
ERR_DONE	LITERAL1
ERR_RF_COLLISION	LITERAL1
ERR_HW_OVERRUN	LITERAL1
ERR_RELEASE_REQ	LITERAL1
ERR_SLEEP_REQ	LITERAL1
ERR_WRONG_STATE	LITERAL1
ERR_MAX_RERUNS	LITERAL1
ERR_DISABLED	LITERAL1
ERR_HW_MISMATCH	LITERAL1
ERR_LINK_LOSS	LITERAL1
ERR_INVALID_HANDLE	LITERAL1
ERR_INCOMPLETE_BYTE	LITERAL1
ERR_INCOMPLETE_BYTE_01	LITERAL1
ERR_INCOMPLETE_BYTE_02	LITERAL1
ERR_INCOMPLETE_BYTE_03	LITERAL1
ERR_INCOMPLETE_BYTE_04	LITERAL1
ERR_INCOMPLETE_BYTE_05	LITERAL1
ERR_INCOMPLETE_BYTE_06	LITERAL1
ERR_INCOMPLETE_BYTE_07	LITERAL1
ERR_GENERIC_GRP	LITERAL1
ERR_WARN_GRP	LITERAL1
ERR_PROCESS_GRP	LITERAL1
ERR_SIO_GRP	LITERAL1
ERR_RINGBUF_GRP	LITERAL1
ERR_MQ_GRP	LITERAL1
ERR_TIMER_GRP	LITERAL1
ERR_RFAL_GRP	LITERAL1
ERR_UART_GRP	LITERAL1
ERR_SPI_GRP	LITERAL1
ERR_I2C_GRP	LITERAL1
